10
-.B.B.-.-.S.B.-.-.-
B.P.P.B.S.W.P.B.G.-
-.B.B.G.G.BS.B.-.-.-
B.P.B.-.B.P.B.-.G.-
P.B.-.-.-.B.P.BS.-.-
B.-.-.-.-.-.BS.W.S.-
-.-.G.-.-.-.-.S.-.-
-.G.-.G.-.-.B.G.B.-
-.-.G.-.-.B.P.B.P.B
A.-.-.-.-.-.B.-.B.-