10
-.-.B.-.-.S.B.-.-.-
B.P.P.B.S.W.P.B.G.-
-.B.G.G.G.B.-.-.-.-
B.P.B.-.B.P.-.-.G.-
P.B.-.-.-.-.P.BS.-.-
B.-.-.-.-.-.B.W.S.-
-.-.-.-.-.-.-.-.-.-
-.-.-.-.-.-.B.G.B.-
-.-.-.-.-.-.P.B.P.B
A.-.-.-.-.-.-.-.B.-