10
-.B.P.B.-.-.-.-.-.G
-.-.B.-.-.-.-.-.G.-
-.B.P.B.-.-.-.G.-.-
B.P.B.-.-.-.G.-.-.-
-.B.-.B.-.-.S.-.-.-
-.G.B.P.B.S.W.BS.-.-
G.G.-.B.-.-.BS.G.B.-
-.-.-.-.-.-.-.B.P.B
-.-.-.-.-.-.B.P.B.-
A.-.-.-.-.-.-.BG.G.G