10
W.SG.B.-.-.G.G.G.G.-
S.B.P.B.-.G.G.-.-.-
-.-.BG.G.-.-.-.G.G.S
G.-.-.G.-.-.B.-.SG.W
S.G.-.-.-.B.P.BS.W.S
W.S.G.-.G.-.B.-.S.-
S.-.-.-.-.B.P.B.-.-
W.S.-.-.G.G.B.-.G.-
SG.-.-.B.-.B.-.S.-.G
G.G.B.P.B.P.BS.W.S.-