10
W.SG.B.-.-.-.-.-.-.-
S.B.P.B.-.-.-.-.-.-
-.-.BG.G.-.-.-.G.G.S
G.-.-.-.-.-.B.-.SG.W
S.G.-.-.-.B.P.BS.W.S
W.S.G.-.G.-.B.-.S.-
S.-.-.-.-.B.P.B.-.-
W.S.-.-.G.G.B.-.G.-
SG.-.-.B.-.B.-.S.-.G
A.G.B.P.B.P.BS.W.S.-