10
-.-.B.-.-.-.-.P.B.B
-.-.P.B.-.-.-.B.P.B
-.-.B.G.-.B.-.G.B.S
G.-.-.-.B.P.B.-.S.W
S.G.-.-.-.B.-.-.G.S
W.S.G.-.B.P.B.-.G.-
S.W.S.-.-.B.-.-.-.-
W.BS.-.G.G.G.-.-.G.B
S.P.BG.-.-.-.-.-.B.P
A.B.-.G.-.-.-.-.G.-